– ¿El pene puede ser masculino o femenino? Si mide más de 12 cms es pene, pero si mide menos de 12 cms es una pena.	"Cookie::create(['message' => '– ¿El pene puede ser masculino o femenino? Si mide más de 12 cms es pene, pero si mide menos de 12 cms es una pena.']);"
– A las personas se las conoce por sus palabras.	"Cookie::create(['message' => '– A las personas se las conoce por sus palabras.']);"
– A una mujer hay que amarla, acariciarla, mimarla, abrazarla, besarla, engatusarla, adorarla, enamorarla…A un hombre con solo chupársela basta.	"Cookie::create(['message' => '– A una mujer hay que amarla, acariciarla, mimarla, abrazarla, besarla, engatusarla, adorarla, enamorarla…A un hombre con solo chupársela basta.']);"
– Aclamar es aplaudir con la garganta	"Cookie::create(['message' => '– Aclamar es aplaudir con la garganta']);"
– Algunos matrimonios acaban bien, otros duran toda la vida.	"Cookie::create(['message' => '– Algunos matrimonios acaban bien, otros duran toda la vida.']);"
– Algunos matrimonios acaban bien, otros duran toda la vida.	"Cookie::create(['message' => '– Algunos matrimonios acaban bien, otros duran toda la vida.']);"
– Antes las distancias eran mayores porque el espacio se mide por el tiempo.	"Cookie::create(['message' => '– Antes las distancias eran mayores porque el espacio se mide por el tiempo.']);"
– Cada hombre quiere ser el primer amor de una mujer, cada mujer quiere ser el último amor de un hombre.	"Cookie::create(['message' => '– Cada hombre quiere ser el primer amor de una mujer, cada mujer quiere ser el último amor de un hombre.']);"
– Cada vez que cometo un error me parece descubrir una verdad que no conocía.	"Cookie::create(['message' => '– Cada vez que cometo un error me parece descubrir una verdad que no conocía.']);"
– Como no sabían que era imposible, lo hicieron.	"Cookie::create(['message' => '– Como no sabían que era imposible, lo hicieron.']);"
– Crecen los años, mengua la vida, crecen las cejas, mengua la vista, crecen las bolas, mengua la picha, pero cuando la picha mengua, crece la lengua y sigue la dicha.	"Cookie::create(['message' => '– Crecen los años, mengua la vida, crecen las cejas, mengua la vista, crecen las bolas, mengua la picha, pero cuando la picha mengua, crece la lengua y sigue la dicha.']);"
– Cualquiera se puede equivocar, inclusive yo.	"Cookie::create(['message' => '– Cualquiera se puede equivocar, inclusive yo.']);"
– Cuando el peligro parece ligero, deja de ser ligero.	"Cookie::create(['message' => '– Cuando el peligro parece ligero, deja de ser ligero.']);"
– Cuando la culpa es de todos, la culpa no es de nadie.	"Cookie::create(['message' => '– Cuando la culpa es de todos, la culpa no es de nadie.']);"
– Cuando los ricos hacen la guerra son los pobres los que mueren.	"Cookie::create(['message' => '– Cuando los ricos hacen la guerra son los pobres los que mueren.']);"
– Cuando no sopla el viento, incluso la veleta tiene carácter.	"Cookie::create(['message' => '– Cuando no sopla el viento, incluso la veleta tiene carácter.']);"
– Cuando un medico se equivoca, lo mejor es echarle tierra al asunto.	"Cookie::create(['message' => '– Cuando un medico se equivoca, lo mejor es echarle tierra al asunto.']);"
– Cuando vayas a decir algo, que tus palabras sean mejores que tu silencio.	"Cookie::create(['message' => '– Cuando vayas a decir algo, que tus palabras sean mejores que tu silencio.']);"
– De mucho trabajar no se murió nadie… Pero por las dudas, mejor no arriesgarse.	"Cookie::create(['message' => '– De mucho trabajar no se murió nadie… Pero por las dudas, mejor no arriesgarse.']);"
– Donde la fuerza oprime, la ley se quiebra.	"Cookie::create(['message' => '– Donde la fuerza oprime, la ley se quiebra.']);"
– El amor dura lo que dura dura.	"Cookie::create(['message' => '– El amor dura lo que dura dura.']);"
– El azúcar no engorda…engorda el que se la toma.	"Cookie::create(['message' => '– El azúcar no engorda…engorda el que se la toma.']);"
– El dinero no trae la felicidad, pero en cuanto el primero se va, la segunda lo sigue.	"Cookie::create(['message' => '– El dinero no trae la felicidad, pero en cuanto el primero se va, la segunda lo sigue.']);"
– El error es un arma que acaba siempre por dispararse contra el que la emplea.	"Cookie::create(['message' => '– El error es un arma que acaba siempre por dispararse contra el que la emplea.']);"
"– El malvado descansa algunas veces; el necio, jamás."	"Cookie::create(['message' => '– El malvado descansa algunas veces; el necio, jamás.']);"
– El matrimonio es como las libretas de ahorro: de tanto meter y sacar se pierde el interés	"Cookie::create(['message' => '– El matrimonio es como las libretas de ahorro: de tanto meter y sacar se pierde el interés']);"
– El mayor crimen está ahora no en los que matan, sino en los que no matan pero dejan matar.	"Cookie::create(['message' => '– El mayor crimen está ahora no en los que matan, sino en los que no matan pero dejan matar.']);"
– El pensamiento es la única cosa del Universo de la que no se puede negar su existencia: negar es pensar.	"Cookie::create(['message' => '– El pensamiento es la única cosa del Universo de la que no se puede negar su existencia: negar es pensar.']);"
– El problema de los imparciales es que están sobornados por las dos partes.	"Cookie::create(['message' => '– El problema de los imparciales es que están sobornados por las dos partes.']);"
– El que busca el cielo en la Tierra se ha dormido en clase de geografía.	"Cookie::create(['message' => '– El que busca el cielo en la Tierra se ha dormido en clase de geografía.']);"
– El que busca la verdad corre el riesgo de encontrarla.	"Cookie::create(['message' => '– El que busca la verdad corre el riesgo de encontrarla.']);"
– El que es capaz de sonreír cuando todo le esta saliendo mal, es porque ya tiene pensado a quien echarle la culpa.	"Cookie::create(['message' => '– El que es capaz de sonreír cuando todo le esta saliendo mal, es porque ya tiene pensado a quien echarle la culpa.']);"
– El que nace pobre y feo tiene grandes posibilidades de que al crecer se le desarrollen ambas condiciones.	"Cookie::create(['message' => '– El que nace pobre y feo tiene grandes posibilidades de que al crecer se le desarrollen ambas condiciones.']);"
– El que no aplique nuevos remedios debe esperar nuevos males, porque el tiempo es el máximo innovador.	"Cookie::create(['message' => '– El que no aplique nuevos remedios debe esperar nuevos males, porque el tiempo es el máximo innovador.']);"
– El requisito del éxito es la prontitud en las decisiones.	"Cookie::create(['message' => '– El requisito del éxito es la prontitud en las decisiones.']);"
– El silencio es la virtud de los locos	"Cookie::create(['message' => '– El silencio es la virtud de los locos']);"
– El tiempo es el ángel del hombre.	"Cookie::create(['message' => '– El tiempo es el ángel del hombre.']);"
– El tiempo es el mejor maestro, desgraciadamente mata a todos sus estudiantes.	"Cookie::create(['message' => '– El tiempo es el mejor maestro, desgraciadamente mata a todos sus estudiantes.']);"
– Emplea el lenguaje que quieras y nunca podrás expresar sino lo que eres.	"Cookie::create(['message' => '– Emplea el lenguaje que quieras y nunca podrás expresar sino lo que eres.']);"
– En estos tiempos se necesita mucho ingenio para cometer un pecado original.	"Cookie::create(['message' => '– En estos tiempos se necesita mucho ingenio para cometer un pecado original.']);"
– En lo pasado está la historia del futuro.	"Cookie::create(['message' => '– En lo pasado está la historia del futuro.']);"
– En materia de gobierno todo cambio es sospechoso, aunque sea para mejorar.	"Cookie::create(['message' => '– En materia de gobierno todo cambio es sospechoso, aunque sea para mejorar.']);"
– Es bueno adquirir poco a poco la conformidad de no entender nada.	"Cookie::create(['message' => '– Es bueno adquirir poco a poco la conformidad de no entender nada.']);"
– Es mejor callar y que piensen que eres idiota a hablar y demostrarlo.	"Cookie::create(['message' => '– Es mejor callar y que piensen que eres idiota a hablar y demostrarlo.']);"
– Es mejor callar y que piensen que eres idiota a hablar y demostrarlo.	"Cookie::create(['message' => '– Es mejor callar y que piensen que eres idiota a hablar y demostrarlo.']);"
– Es muy difícil hacer compatible la política con la moral.	"Cookie::create(['message' => '– Es muy difícil hacer compatible la política con la moral.']);"
– Escoger un camino significa abandonar otros.	"Cookie::create(['message' => '– Escoger un camino significa abandonar otros.']);"
– Estoy en una situación tan delicada que si mi mujer se va con otro, yo me voy con ellos.	"Cookie::create(['message' => '– Estoy en una situación tan delicada que si mi mujer se va con otro, yo me voy con ellos.']);"
– Estoy mas desconcertado que Adán el día de la madre	"Cookie::create(['message' => '– Estoy mas desconcertado que Adán el día de la madre']);"
– Evitemos suplantar con nuestro mundo el de los demás.	"Cookie::create(['message' => '– Evitemos suplantar con nuestro mundo el de los demás.']);"
– Experiencia, es el nombre que le damos a nuestras metidas de pata	"Cookie::create(['message' => '– Experiencia, es el nombre que le damos a nuestras metidas de pata']);"
– Grabad esto en vuestro corazón: cada día es el mejor del año.	"Cookie::create(['message' => '– Grabad esto en vuestro corazón: cada día es el mejor del año.']);"
– Has de saber más que los demás, si puedes, pero no lo digas.	"Cookie::create(['message' => '– Has de saber más que los demás, si puedes, pero no lo digas.']);"
– Hay estudiantes que les apena ir al hipódromo y ver que hasta los caballos logran terminar su carrera.	"Cookie::create(['message' => '– Hay estudiantes que les apena ir al hipódromo y ver que hasta los caballos logran terminar su carrera.']);"
– Hay que tener cuidado al elegir a los enemigos porque uno termina pareciéndose a ellos- El honor consiste en hacer hermoso aquello que uno está obligado a realizar.	"Cookie::create(['message' => '– Hay que tener cuidado al elegir a los enemigos porque uno termina pareciéndose a ellos- El honor consiste en hacer hermoso aquello que uno está obligado a realizar.']);"
– Hay que trabajar ocho horas y dormir ocho horas, pero no las mismas.	"Cookie::create(['message' => '– Hay que trabajar ocho horas y dormir ocho horas, pero no las mismas.']);"
– Hay que unirse, no para estar juntos, sino para hacer algo juntos.	"Cookie::create(['message' => '– Hay que unirse, no para estar juntos, sino para hacer algo juntos.']);"
– Hay tres tipos de personas: los que saben contar y los que no.	"Cookie::create(['message' => '– Hay tres tipos de personas: los que saben contar y los que no.']);"
– Hay un mundo mejor ¡Pero es muy caro!	"Cookie::create(['message' => '– Hay un mundo mejor ¡Pero es muy caro!']);"
– He oído hablar tan bien de ti, que creía que estabas muerto.	"Cookie::create(['message' => '– He oído hablar tan bien de ti, que creía que estabas muerto.']);"
– Huye de las tentaciones, pero despacio, para que puedan alcanzarte.	"Cookie::create(['message' => '– Huye de las tentaciones, pero despacio, para que puedan alcanzarte.']);"
– La antigüedad del tiempo es la juventud del mundo.	"Cookie::create(['message' => '– La antigüedad del tiempo es la juventud del mundo.']);"
– La discreción en el habla es más que la elocuencia.	"Cookie::create(['message' => '– La discreción en el habla es más que la elocuencia.']);"
– La duda es uno de los nombres de la inteligencia.	"Cookie::create(['message' => '– La duda es uno de los nombres de la inteligencia.']);"
– La fuerza es la Ley de la Bestia	"Cookie::create(['message' => '– La fuerza es la Ley de la Bestia']);"
– La gente no busca razones para hacer lo que quiere hacer, busca excusas.	"Cookie::create(['message' => '– La gente no busca razones para hacer lo que quiere hacer, busca excusas.']);"
– La historia del toreo está ligada a España, tanto que sin conocer la primera, resulta imposible comprender la segunda.	"Cookie::create(['message' => '– La historia del toreo está ligada a España, tanto que sin conocer la primera, resulta imposible comprender la segunda.']);"
– La historia es un incesante volver a empezar.	"Cookie::create(['message' => '– La historia es un incesante volver a empezar.']);"
– La historia universal es la de un solo hombre.	"Cookie::create(['message' => '– La historia universal es la de un solo hombre.']);"
– La libertad es lo que haces con lo que te han hecho.	"Cookie::create(['message' => '– La libertad es lo que haces con lo que te han hecho.']);"
– La magia es un puente que te permite ir del mundo visible hacia el invisible, y aprender las lecciones de ambos mundos.	"Cookie::create(['message' => '– La magia es un puente que te permite ir del mundo visible hacia el invisible, y aprender las lecciones de ambos mundos.']);"
– La mujer que no tiene suerte con los hombres no sabe la suerte que tiene.	"Cookie::create(['message' => '– La mujer que no tiene suerte con los hombres no sabe la suerte que tiene.']);"
– La política es el arte de buscar problemas, encontrarlos, hacer un diagnostico falso y aplicar después los remedios equivocados.	"Cookie::create(['message' => '– La política es el arte de buscar problemas, encontrarlos, hacer un diagnostico falso y aplicar después los remedios equivocados.']);"
– La política es el arte de buscar problemas, encontrarlos, hacer un diagnostico falso y aplicar después los remedios equivocados.	"Cookie::create(['message' => '– La política es el arte de buscar problemas, encontrarlos, hacer un diagnostico falso y aplicar después los remedios equivocados.']);"
– La primera condición para la inmortalidad es la muerte.	"Cookie::create(['message' => '– La primera condición para la inmortalidad es la muerte.']);"
– La psiquiatría es el único negocio donde el cliente nunca tiene la razón.	"Cookie::create(['message' => '– La psiquiatría es el único negocio donde el cliente nunca tiene la razón.']);"
– La sociedad es en todos los sitios una conspiración contra la personalidad de cada uno de sus miembros.	"Cookie::create(['message' => '– La sociedad es en todos los sitios una conspiración contra la personalidad de cada uno de sus miembros.']);"
"– La talla de las estatuas disminuye alejándose de ellas; la de los hombres, aproximándose."	"Cookie::create(['message' => '– La talla de las estatuas disminuye alejándose de ellas; la de los hombres, aproximándose.']);"
– La última vez que estuve dentro de una mujer fue cuando visité la Estatua de la Libertad.	"Cookie::create(['message' => '– La última vez que estuve dentro de una mujer fue cuando visité la Estatua de la Libertad.']);"
– La verdad absoluta no existe y esto es absolutamente cierto.	"Cookie::create(['message' => '– La verdad absoluta no existe y esto es absolutamente cierto.']);"
– La verdad es hija del tiempo, no de la autoridad.	"Cookie::create(['message' => '– La verdad es hija del tiempo, no de la autoridad.']);"
– La vida cobra sentido cuando se hace de ella una aspiración a no renunciar a nada.	"Cookie::create(['message' => '– La vida cobra sentido cuando se hace de ella una aspiración a no renunciar a nada.']);"
– La vida es una extraña mezcla de azar, destino y carácter.	"Cookie::create(['message' => '– La vida es una extraña mezcla de azar, destino y carácter.']);"
– La vocación del político de carrera es hacer de cada solución un problema.	"Cookie::create(['message' => '– La vocación del político de carrera es hacer de cada solución un problema.']);"
– Las conductas, como las enfermedades, se contagian de unos a otros.	"Cookie::create(['message' => '– Las conductas, como las enfermedades, se contagian de unos a otros.']);"
– Las fuerzas que se asocian para el bien no se suman, se multiplican.	"Cookie::create(['message' => '– Las fuerzas que se asocian para el bien no se suman, se multiplican.']);"
– Las mujeres son como las traducciones: Si son fieles, difícilmente sean tan bellas y, si son bellas, difícilmente sean tan fieles.	"Cookie::create(['message' => '– Las mujeres son como las traducciones: Si son fieles, difícilmente sean tan bellas y, si son bellas, difícilmente sean tan fieles.']);"
– Le quiero como a un hermano. Como Caín a Abel.	"Cookie::create(['message' => '– Le quiero como a un hermano. Como Caín a Abel.']);"
– Lo importante no es escuchar lo que se dice, sino averiguar lo que se piensa.	"Cookie::create(['message' => '– Lo importante no es escuchar lo que se dice, sino averiguar lo que se piensa.']);"
– Lo importante no es ganar sino hacer perder al otro.	"Cookie::create(['message' => '– Lo importante no es ganar sino hacer perder al otro.']);"
– Lo importante no es lo que han hecho de nosotros, sino lo que hacemos con lo que han hecho de nosotros.	"Cookie::create(['message' => '– Lo importante no es lo que han hecho de nosotros, sino lo que hacemos con lo que han hecho de nosotros.']);"
– Lo importante no es saber, sino tener el teléfono del que sabe	"Cookie::create(['message' => '– Lo importante no es saber, sino tener el teléfono del que sabe']);"
– Los años enseñan muchas cosas que los días jamás llegan a conocer.	"Cookie::create(['message' => '– Los años enseñan muchas cosas que los días jamás llegan a conocer.']);"
– Los astutos vencen siempre en el primer momento, y suelen ser vencidos antes del fin.	"Cookie::create(['message' => '– Los astutos vencen siempre en el primer momento, y suelen ser vencidos antes del fin.']);"
– Me interesa el futuro porque es el sitio donde voy a pasar el resto de mi vida.	"Cookie::create(['message' => '– Me interesa el futuro porque es el sitio donde voy a pasar el resto de mi vida.']);"
– Mejor que nos gobiernen las prostitutas porque estamos cansados que nos gobiernen sus hijos.	"Cookie::create(['message' => '– Mejor que nos gobiernen las prostitutas porque estamos cansados que nos gobiernen sus hijos.']);"
– Mejor que nos gobiernen las prostitutas porque estamos cansados que nos gobiernen sus hijos.	"Cookie::create(['message' => '– Mejor que nos gobiernen las prostitutas porque estamos cansados que nos gobiernen sus hijos.']);"
– Mi cerebro es mi segundo órgano favorito.	"Cookie::create(['message' => '– Mi cerebro es mi segundo órgano favorito.']);"
– Mientras mas estudiamos, mas sabemos, mientras mas sabemos, mas olvidamos, mientras mas olvidamos, menos sabemos, entonces ¿Para que estudiamos?	"Cookie::create(['message' => '– Mientras mas estudiamos, mas sabemos, mientras mas sabemos, mas olvidamos, mientras mas olvidamos, menos sabemos, entonces ¿Para que estudiamos?']);"
– Morir es como dormir, pero sin levantarse a hacer pis.	"Cookie::create(['message' => '– Morir es como dormir, pero sin levantarse a hacer pis.']);"
– Nacemos desnudos, húmedos y hambrientos. Después la cosa empeora.	"Cookie::create(['message' => '– Nacemos desnudos, húmedos y hambrientos. Después la cosa empeora.']);"
– Nada induce al hombre a sospechar mucho como el saber poco.	"Cookie::create(['message' => '– Nada induce al hombre a sospechar mucho como el saber poco.']);"
– National Geographic confirma definitivamente que el chocho no es una almeja, sino un caracol, si lo tocas babea, y si no lo tocas te pone los cuernos.	"Cookie::create(['message' => '– National Geographic confirma definitivamente que el chocho no es una almeja, sino un caracol, si lo tocas babea, y si no lo tocas te pone los cuernos.']);"
– No creo en una vida posterior, pero por si acaso me he cambiado de ropa interior.	"Cookie::create(['message' => '– No creo en una vida posterior, pero por si acaso me he cambiado de ropa interior.']);"
– No deje para mañana lo que puede evitar definitivamente.	"Cookie::create(['message' => '– No deje para mañana lo que puede evitar definitivamente.']);"
– No es la carne y la sangre, sino el corazón, lo que nos hace padres e hijos.	"Cookie::create(['message' => '– No es la carne y la sangre, sino el corazón, lo que nos hace padres e hijos.']);"
– No es que tenga miedo de morirme, es tan sólo que no quiero estar allí cuando suceda.	"Cookie::create(['message' => '– No es que tenga miedo de morirme, es tan sólo que no quiero estar allí cuando suceda.']);"
– No existe la casualidad, y lo que se nos presenta como azar surge de las fuentes más profundas.	"Cookie::create(['message' => '– No existe la casualidad, y lo que se nos presenta como azar surge de las fuentes más profundas.']);"
– No existe una mejor prueba de progreso de una civilización que la del progreso de la cooperación.	"Cookie::create(['message' => '– No existe una mejor prueba de progreso de una civilización que la del progreso de la cooperación.']);"
– No importa cuantas veces un hombre casado cambie de trabajo… siempre sigue con la misma jefa.	"Cookie::create(['message' => '– No importa cuantas veces un hombre casado cambie de trabajo… siempre sigue con la misma jefa.']);"
– No lo que hicimos ayer, sino lo que vamos a hacer mañana juntos, no reúne en Estado.	"Cookie::create(['message' => '– No lo que hicimos ayer, sino lo que vamos a hacer mañana juntos, no reúne en Estado.']);"
– No nos une el amor, nos une el espanto.	"Cookie::create(['message' => '– No nos une el amor, nos une el espanto.']);"
– No solía acabar nada, pero ahora…	"Cookie::create(['message' => '– No solía acabar nada, pero ahora…']);"
– No te metas con la masturbación. Es hacer el amor con alguien a quien yo quiero.	"Cookie::create(['message' => '– No te metas con la masturbación. Es hacer el amor con alguien a quien yo quiero.']);"
– No te tomes la vida en serio, al fin al cabo no saldrás vivo de ella.	"Cookie::create(['message' => '– No te tomes la vida en serio, al fin al cabo no saldrás vivo de ella.']);"
– No te tomes la vida en serio, al fin al cabo no saldrás vivo de ella.	"Cookie::create(['message' => '– No te tomes la vida en serio, al fin al cabo no saldrás vivo de ella.']);"
– No tengo nada en contra de la ciencia. Yo, entre el aire acondicionado y el Papa, escojo el aire.	"Cookie::create(['message' => '– No tengo nada en contra de la ciencia. Yo, entre el aire acondicionado y el Papa, escojo el aire.']);"
– Optimista es aquél que cree poder resolver un atasco de tráfico tocando el claxon.	"Cookie::create(['message' => '– Optimista es aquél que cree poder resolver un atasco de tráfico tocando el claxon.']);"
– Para obtener un préstamo, primero debe probar que no lo necesita.	"Cookie::create(['message' => '– Para obtener un préstamo, primero debe probar que no lo necesita.']);"
– Que cada día sea un renacer, con nuevas esperanzas	"Cookie::create(['message' => '– Que cada día sea un renacer, con nuevas esperanzas']);"
– Que tan largo puede ser un minuto dependerá de en que lado de la puerta del baño estas	"Cookie::create(['message' => '– Que tan largo puede ser un minuto dependerá de en que lado de la puerta del baño estas']);"
"– Quien no quiere pensar es un fanático; quien no puede pensar es un idiota; quien no osa pensar es un cobarde."	"Cookie::create(['message' => '– Quien no quiere pensar es un fanático; quien no puede pensar es un idiota; quien no osa pensar es un cobarde.']);"
– Recuerda siempre que eres único… Exactamente igual que todos los demás.	"Cookie::create(['message' => '– Recuerda siempre que eres único… Exactamente igual que todos los demás.']);"
– Recuerda siempre que eres único… Exactamente igual que todos los demás.	"Cookie::create(['message' => '– Recuerda siempre que eres único… Exactamente igual que todos los demás.']);"
– Se bueno con tus hijos. Ellos elegirán tu residencia.	"Cookie::create(['message' => '– Se bueno con tus hijos. Ellos elegirán tu residencia.']);"
– Se puede aprender mucho sobre el amor en el cine… si no nos distrae la película	"Cookie::create(['message' => '– Se puede aprender mucho sobre el amor en el cine… si no nos distrae la película']);"
– Ser una mujer es una tarea terriblemente difícil, ya que consiste principalmente en tratar con hombres.	"Cookie::create(['message' => '– Ser una mujer es una tarea terriblemente difícil, ya que consiste principalmente en tratar con hombres.']);"
– Si a la primera no lo haces bien, el paracaidismo no es lo tuyo.	"Cookie::create(['message' => '– Si a la primera no lo haces bien, el paracaidismo no es lo tuyo.']);"
– Si algo podemos reconocerle a los reincidentes es que no andan cambiando de ideas.	"Cookie::create(['message' => '– Si algo podemos reconocerle a los reincidentes es que no andan cambiando de ideas.']);"
– Si algún día te sientes pequeño, inútil ultrajado y deprimido, recuerda que un día fuiste el espermatozoide mas rápido y victorioso de tu grupo.	"Cookie::create(['message' => '– Si algún día te sientes pequeño, inútil ultrajado y deprimido, recuerda que un día fuiste el espermatozoide mas rápido y victorioso de tu grupo.']);"
– Si amas algo, déjalo libre, si regresa a ti, es tuyo, si no regresa, nunca lo fue.	"Cookie::create(['message' => '– Si amas algo, déjalo libre, si regresa a ti, es tuyo, si no regresa, nunca lo fue.']);"
– Si buscas una mano dispuesta a ayudarte, la encontraras al final de tu brazo.	"Cookie::create(['message' => '– Si buscas una mano dispuesta a ayudarte, la encontraras al final de tu brazo.']);"
"– Si comienza uno con certezas, terminará con dudas; más si acepta empezar con dudas, llegará a terminar con certezas."	"Cookie::create(['message' => '– Si comienza uno con certezas, terminará con dudas; más si acepta empezar con dudas, llegará a terminar con certezas.']);"
– Si de algo soy rico es de perplejidades y no de certezas.	"Cookie::create(['message' => '– Si de algo soy rico es de perplejidades y no de certezas.']);"
– Si el dinero pudiera hablar me diría Adiós	"Cookie::create(['message' => '– Si el dinero pudiera hablar me diría Adiós']);"
– Si le molesta el más allá, póngase más acá.	"Cookie::create(['message' => '– Si le molesta el más allá, póngase más acá.']);"
– Si no puedes convencerlos, confúndelos.	"Cookie::create(['message' => '– Si no puedes convencerlos, confúndelos.']);"
– Si no tiene nada que hacer, por favor no lo haga aquí.	"Cookie::create(['message' => '– Si no tiene nada que hacer, por favor no lo haga aquí.']);"
– Si quieres comprender a los demás, mira en tu propio corazón.	"Cookie::create(['message' => '– Si quieres comprender a los demás, mira en tu propio corazón.']);"
– Si quieres conocerte, observa la conducta de los demás.	"Cookie::create(['message' => '– Si quieres conocerte, observa la conducta de los demás.']);"
– Si viéramos realmente el Universo, tal vez lo entenderíamos.	"Cookie::create(['message' => '– Si viéramos realmente el Universo, tal vez lo entenderíamos.']);"
– Siempre imaginé que el Paraíso sería algún tipo de biblioteca.	"Cookie::create(['message' => '– Siempre imaginé que el Paraíso sería algún tipo de biblioteca.']);"
– Siento pasos, siento gente, siento quince y siento veinte	"Cookie::create(['message' => '– Siento pasos, siento gente, siento quince y siento veinte']);"
– Silenciar una versión es una peculiar forma de hacer mal.	"Cookie::create(['message' => '– Silenciar una versión es una peculiar forma de hacer mal.']);"
– Sólo la fantasía permanece siempre joven, lo que no ha ocurrido jamás no envejece nunca.	"Cookie::create(['message' => '– Sólo la fantasía permanece siempre joven, lo que no ha ocurrido jamás no envejece nunca.']);"
– Solo los genios somos modestos.	"Cookie::create(['message' => '– Solo los genios somos modestos.']);"
– Solo los genios somos modestos.	"Cookie::create(['message' => '– Solo los genios somos modestos.']);"
– Solo los genios somos modestos.	"Cookie::create(['message' => '– Solo los genios somos modestos.']);"
– Sólo se inventa mediante el recuerdo.	"Cookie::create(['message' => '– Sólo se inventa mediante el recuerdo.']);"
– Sonríe es lo segundo mejor que puedes hacer con tus labios	"Cookie::create(['message' => '– Sonríe es lo segundo mejor que puedes hacer con tus labios']);"
– Tener la conciencia limpia, solo es síntoma de mala memoria.	"Cookie::create(['message' => '– Tener la conciencia limpia, solo es síntoma de mala memoria.']);"
– Todas las batallas en la vida sirven para enseñarnos algo, inclusive aquellas que perdemos.	"Cookie::create(['message' => '– Todas las batallas en la vida sirven para enseñarnos algo, inclusive aquellas que perdemos.']);"
– Todas las cosas son imposibles, mientras lo parecen.	"Cookie::create(['message' => '– Todas las cosas son imposibles, mientras lo parecen.']);"
– Todo es resultado de un esfuerzo. Sólo se aguanta una civilización si muchos aportan su colaboración al esfuerzo.	"Cookie::create(['message' => '– Todo es resultado de un esfuerzo. Sólo se aguanta una civilización si muchos aportan su colaboración al esfuerzo.']);"
– Todo hombre no vive más que por lo que espera.	"Cookie::create(['message' => '– Todo hombre no vive más que por lo que espera.']);"
– Todo tiempo pasado fue anterior.	"Cookie::create(['message' => '– Todo tiempo pasado fue anterior.']);"
– Todos deberíamos creer en algo. Yo creo que tomaré otra copa.	"Cookie::create(['message' => '– Todos deberíamos creer en algo. Yo creo que tomaré otra copa.']);"
– Trabaja como si no necesitaras el dinero, ama como si nunca te hubieran herido, y baila como si nadie te estuviera viendo.	"Cookie::create(['message' => '– Trabaja como si no necesitaras el dinero, ama como si nunca te hubieran herido, y baila como si nadie te estuviera viendo.']);"
– Un día leí que fumar era malo y dejé de fumar. Un día leí que beber era malo y dejé de beber. Un día leí que follar era malo y dejé de leer.	"Cookie::create(['message' => '– Un día leí que fumar era malo y dejé de fumar. Un día leí que beber era malo y dejé de beber. Un día leí que follar era malo y dejé de leer.']);"
– Un día sin sol es como, ya sabes, noche.	"Cookie::create(['message' => '– Un día sin sol es como, ya sabes, noche.']);"
– Un héroe no es más valiente que un hombre normal, pero es valiente cinco minutos más.	"Cookie::create(['message' => '– Un héroe no es más valiente que un hombre normal, pero es valiente cinco minutos más.']);"
"– Un hombre aislado se siente débil, y lo es.- La pasión para el hombre es un torrente; para la mujer, un abismo."	"Cookie::create(['message' => '– Un hombre aislado se siente débil, y lo es.- La pasión para el hombre es un torrente; para la mujer, un abismo.']);"
– Una prostituta es una señora que al desvestirse queda en ropa de trabajo.	"Cookie::create(['message' => '– Una prostituta es una señora que al desvestirse queda en ropa de trabajo.']);"
– Únicamente la obediencia tiene derecho al mando.	"Cookie::create(['message' => '– Únicamente la obediencia tiene derecho al mando.']);"
– Uno no es lo que es por lo que escribe, sino por lo que ha leído.	"Cookie::create(['message' => '– Uno no es lo que es por lo que escribe, sino por lo que ha leído.']);"
"– Vengándose, uno se iguala a su enemigo; perdonándolo, se muestra superior a él."	"Cookie::create(['message' => '– Vengándose, uno se iguala a su enemigo; perdonándolo, se muestra superior a él.']);"
– Vieja madera para arder, viejo vino para beber, viejos amigos en quien confiar, y viejos autores para leer.	"Cookie::create(['message' => '– Vieja madera para arder, viejo vino para beber, viejos amigos en quien confiar, y viejos autores para leer.']);"
– Yo no sufro de locura… la disfruto a cada minuto.	"Cookie::create(['message' => '– Yo no sufro de locura… la disfruto a cada minuto.']);"
– Yo si se lo que es trabajar duro, de verdad, porque lo he visto.	"Cookie::create(['message' => '– Yo si se lo que es trabajar duro, de verdad, porque lo he visto.']);"
!Auxilio, soy rehen de una panadería de galletas de la fortuna!	"Cookie::create(['message' => '!Auxilio, soy rehen de una panadería de galletas de la fortuna!']);"
!Ella lo sabe todo!	"Cookie::create(['message' => '!Ella lo sabe todo!']);"
!Lotería!	"Cookie::create(['message' => '!Lotería!']);"
404 fortuna no encontrada.	"Cookie::create(['message' => '404 fortuna no encontrada.']);"
Agítese antes de usar.	"Cookie::create(['message' => 'Agítese antes de usar.']);"
Antes de perder la vida, prefiero la muerte!!	"Cookie::create(['message' => 'Antes de perder la vida, prefiero la muerte!!']);"
Baterías no incluidas.	"Cookie::create(['message' => 'Baterías no incluidas.']);"
Boleto no premiado !sigue participando!	"Cookie::create(['message' => 'Boleto no premiado !sigue participando!']);"
Cambio lindo perro Doberman por mano ortopédica.	"Cookie::create(['message' => 'Cambio lindo perro Doberman por mano ortopédica.']);"
Chico tímido busca… bueno… esteeee… no, bueno… nada… no importa…	"Cookie::create(['message' => 'Chico tímido busca… bueno… esteeee… no, bueno… nada… no importa…']);"
CocaCola, siempre en los grandes eventos.	"Cookie::create(['message' => 'CocaCola, siempre en los grandes eventos.']);"
Coloca pierna derecha sobre el rojo.	"Cookie::create(['message' => 'Coloca pierna derecha sobre el rojo.']);"
Cuidado con la comida China hoy, puede que te enfermes.	"Cookie::create(['message' => 'Cuidado con la comida China hoy, puede que te enfermes.']);"
De lo que das eso justamente recibirás	"Cookie::create(['message' => 'De lo que das eso justamente recibirás']);"
Deberás llevar el Halcón de Jade al aeropuerto a media noche.	"Cookie::create(['message' => 'Deberás llevar el Halcón de Jade al aeropuerto a media noche.']);"
Deja de planear tanto las cosas y permite que la vida te sorprenda	"Cookie::create(['message' => 'Deja de planear tanto las cosas y permite que la vida te sorprenda']);"
Divorcios 24 horas. Satisfacción garantizada o le devolvemos a su cónyuge.	"Cookie::create(['message' => 'Divorcios 24 horas. Satisfacción garantizada o le devolvemos a su cónyuge.']);"
El amor eterno dura aproximadamente 3 meses.	"Cookie::create(['message' => 'El amor eterno dura aproximadamente 3 meses.']);"
El amor eterno dura tres meses.	"Cookie::create(['message' => 'El amor eterno dura tres meses.']);"
El dinero no hace la felicidad. La compra hecha.	"Cookie::create(['message' => 'El dinero no hace la felicidad. La compra hecha.']);"
El fin se acerca, y es TU culpa.	"Cookie::create(['message' => 'El fin se acerca, y es TU culpa.']);"
El que nace pa tamal nunca ta bien.	"Cookie::create(['message' => 'El que nace pa tamal nunca ta bien.']);"
El que nace pobre y feo tiene grandes posibilidades de que al crecer se le desarrollen ambas condiciones.	"Cookie::create(['message' => 'El que nace pobre y feo tiene grandes posibilidades de que al crecer se le desarrollen ambas condiciones.']);"
El que nace pobre y feo tiene grandes posibilidades de que al crecer se le desarrollen ambas condiciones.	"Cookie::create(['message' => 'El que nace pobre y feo tiene grandes posibilidades de que al crecer se le desarrollen ambas condiciones.']);"
El que quiera celeste, que mezcle azul y blanco.	"Cookie::create(['message' => 'El que quiera celeste, que mezcle azul y blanco.']);"
El que quiere celeste que mezcle azul y blanco.	"Cookie::create(['message' => 'El que quiere celeste que mezcle azul y blanco.']);"
El que ríe de ultimo no entendió el chiste.	"Cookie::create(['message' => 'El que ríe de ultimo no entendió el chiste.']);"
El secreto del fracaso es darle gusto a todo el mundo 	"Cookie::create(['message' => 'El secreto del fracaso es darle gusto a todo el mundo ']);"
En cada madre hay una suegra en potencia.	"Cookie::create(['message' => 'En cada madre hay una suegra en potencia.']);"
"En un lado: ""¿Sábes cómo mantener a un idiota ocupado todo el día? Dale la vuelta."" En el otro: ""¿Sábes cómo mantener a un idiota ocupado todo el día? Dale la vuelta.""."	"Cookie::create(['message' => 'En un lado: ""¿Sábes cómo mantener a un idiota ocupado todo el día? Dale la vuelta."" En el otro: ""¿Sábes cómo mantener a un idiota ocupado todo el día? Dale la vuelta."".']);"
Errar es humano, pero echarle la culpa a otro es más humano todavía.	"Cookie::create(['message' => 'Errar es humano, pero echarle la culpa a otro es más humano todavía.']);"
Es bueno dejar el trago, lo malo es no acordarse donde.	"Cookie::create(['message' => 'Es bueno dejar el trago, lo malo es no acordarse donde.']);"
Eso no era pollo.	"Cookie::create(['message' => 'Eso no era pollo.']);"
Espacio en renta.	"Cookie::create(['message' => 'Espacio en renta.']);"
Esta obsesión de suicidio me está matando.	"Cookie::create(['message' => 'Esta obsesión de suicidio me está matando.']);"
Este mensaje miente.	"Cookie::create(['message' => 'Este mensaje miente.']);"
Este mensaje se auto-destruirá en cinco segundos.	"Cookie::create(['message' => 'Este mensaje se auto-destruirá en cinco segundos.']);"
Estudiar es desconfiar de la inteligencia del compañero de al lado.	"Cookie::create(['message' => 'Estudiar es desconfiar de la inteligencia del compañero de al lado.']);"
Frases chistosas de anuncios clasificados.	"Cookie::create(['message' => 'Frases chistosas de anuncios clasificados.']);"
Garantía inválida una vez abierto el empaque.	"Cookie::create(['message' => 'Garantía inválida una vez abierto el empaque.']);"
graciosas	"Cookie::create(['message' => 'graciosas']);"
Hagas lo que hagas no te comas esta gall... oh, demasiado tarde.	"Cookie::create(['message' => 'Hagas lo que hagas no te comas esta gall... oh, demasiado tarde.']);"
Hay un mundo mejor, pero es carísimo.	"Cookie::create(['message' => 'Hay un mundo mejor, pero es carísimo.']);"
Hay un mundo mejor, pero es carísimo.	"Cookie::create(['message' => 'Hay un mundo mejor, pero es carísimo.']);"
Hoy es el primer día del resto de tu vida, ¿y hasta ahora te das cuenta?	"Cookie::create(['message' => 'Hoy es el primer día del resto de tu vida, ¿y hasta ahora te das cuenta?']);"
Huye de las tentaciones…despacio para que puedan alcanzarte.	"Cookie::create(['message' => 'Huye de las tentaciones…despacio para que puedan alcanzarte.']);"
Ignora el mensaje de la siguiente galleta de la suerte.	"Cookie::create(['message' => 'Ignora el mensaje de la siguiente galleta de la suerte.']);"
Inteligencia militar es una contradicción.	"Cookie::create(['message' => 'Inteligencia militar es una contradicción.']);"
La droga te buelbe bruto.	"Cookie::create(['message' => 'La droga te buelbe bruto.']);"
La esclavitud no se abolió, se cambió a 8 horas diarias.	"Cookie::create(['message' => 'La esclavitud no se abolió, se cambió a 8 horas diarias.']);"
La inteligencia me persigue pero yo soy mas rápido.	"Cookie::create(['message' => 'La inteligencia me persigue pero yo soy mas rápido.']);"
La mujer que no tiene suerte con los hombres no sabe la suerte que tiene.	"Cookie::create(['message' => 'La mujer que no tiene suerte con los hombres no sabe la suerte que tiene.']);"
La pereza es la madre de todos los vicios y como madre, hay que respetarla.	"Cookie::create(['message' => 'La pereza es la madre de todos los vicios y como madre, hay que respetarla.']);"
La policía está en camino !huye!	"Cookie::create(['message' => 'La policía está en camino !huye!']);"
La psiquiatría es el único negocio donde el cliente “nunca tiene la razón” Que tal!!!	"Cookie::create(['message' => 'La psiquiatría es el único negocio donde el cliente “nunca tiene la razón” Que tal!!!']);"
La suerte que buscas está en otra galleta.	"Cookie::create(['message' => 'La suerte que buscas está en otra galleta.']);"
La verdad absoluta no existe y esto es absolutamente cierto.	"Cookie::create(['message' => 'La verdad absoluta no existe y esto es absolutamente cierto.']);"
La verdad está allá afuera.	"Cookie::create(['message' => 'La verdad está allá afuera.']);"
La verdad no es absoluta y esto es absolutamente verdadero	"Cookie::create(['message' => 'La verdad no es absoluta y esto es absolutamente verdadero']);"
Lo importante es el dinero. La salud va y viene.	"Cookie::create(['message' => 'Lo importante es el dinero. La salud va y viene.']);"
Lo importante es la plata, la salud va y viene.	"Cookie::create(['message' => 'Lo importante es la plata, la salud va y viene.']);"
Lo importante no es ganar sino hacer perder al otro.	"Cookie::create(['message' => 'Lo importante no es ganar sino hacer perder al otro.']);"
Lo importante no es ganar, sino hacer perder al otro.	"Cookie::create(['message' => 'Lo importante no es ganar, sino hacer perder al otro.']);"
Lo importante no es saber, sino tener el teléfono del que sabe.	"Cookie::create(['message' => 'Lo importante no es saber, sino tener el teléfono del que sabe.']);"
Lo sentimos, su fortuna ha sido rechazada, por favor vuelva a intentar.	"Cookie::create(['message' => 'Lo sentimos, su fortuna ha sido rechazada, por favor vuelva a intentar.']);"
Los honestos son inadaptados sociales.	"Cookie::create(['message' => 'Los honestos son inadaptados sociales.']);"
Más vale borracho conocido que alcohólico anónimo.	"Cookie::create(['message' => 'Más vale borracho conocido que alcohólico anónimo.']);"
Ningún tonto se queja de serlo. No les debe ir tan mal.	"Cookie::create(['message' => 'Ningún tonto se queja de serlo. No les debe ir tan mal.']);"
No confíes en nadie.	"Cookie::create(['message' => 'No confíes en nadie.']);"
No hay mujer fea, sólo belleza rara.	"Cookie::create(['message' => 'No hay mujer fea, sólo belleza rara.']);"
No se deje al alcance de los niños.	"Cookie::create(['message' => 'No se deje al alcance de los niños.']);"
No soy un completo inútil. Por lo menos sirvo de mal ejemplo.	"Cookie::create(['message' => 'No soy un completo inútil. Por lo menos sirvo de mal ejemplo.']);"
"No soy un completo inútil; por lo menos sirvo de mal ejemplo"	"Cookie::create(['message' => 'No soy un completo inútil; por lo menos sirvo de mal ejemplo']);"
No te metas en el mundo de las drogas. Ya somos muchos y hay muy poca.	"Cookie::create(['message' => 'No te metas en el mundo de las drogas. Ya somos muchos y hay muy poca.']);"
No te tomes la vida en serio, al fin y al cabo no saldrás vivo de ella.	"Cookie::create(['message' => 'No te tomes la vida en serio, al fin y al cabo no saldrás vivo de ella.']);"
Nunca le pegues a un hombre con anteojos….. Pégale con algo más duro y pesado.	"Cookie::create(['message' => 'Nunca le pegues a un hombre con anteojos….. Pégale con algo más duro y pesado.']);"
Ojos que no ven… zapatos llenos de caca.	"Cookie::create(['message' => 'Ojos que no ven… zapatos llenos de caca.']);"
Para continuar, inserte una moneda.	"Cookie::create(['message' => 'Para continuar, inserte una moneda.']);"
Para solucionar el hambre y la pobreza… ¡¡Comed un pobre!!	"Cookie::create(['message' => 'Para solucionar el hambre y la pobreza… ¡¡Comed un pobre!!']);"
Pez que lucha contra la corriente muere electrocutado.	"Cookie::create(['message' => 'Pez que lucha contra la corriente muere electrocutado.']);"
Pez que lucha contra la corriente, muere electrocutado.	"Cookie::create(['message' => 'Pez que lucha contra la corriente, muere electrocutado.']);"
Por diabetes vendo mi flauta dulce.	"Cookie::create(['message' => 'Por diabetes vendo mi flauta dulce.']);"
Rómpase en caso de incendio.	"Cookie::create(['message' => 'Rómpase en caso de incendio.']);"
Se esta muriendo gente que antes no se moría.	"Cookie::create(['message' => 'Se esta muriendo gente que antes no se moría.']);"
Sé lo que hiciste el almuerzo pasado.	"Cookie::create(['message' => 'Sé lo que hiciste el almuerzo pasado.']);"
Si estás leyendo este mensaje, ya es demasiado tarde para mí...	"Cookie::create(['message' => 'Si estás leyendo este mensaje, ya es demasiado tarde para mí...']);"
Si la montaña viene hacia a ti… corre… es un derrumbe!	"Cookie::create(['message' => 'Si la montaña viene hacia a ti… corre… es un derrumbe!']);"
Si la montaña viene hacia ti, corre, es un derrumbe.	"Cookie::create(['message' => 'Si la montaña viene hacia ti, corre, es un derrumbe.']);"
Si no eres parte de la solución, eres parte del problema.	"Cookie::create(['message' => 'Si no eres parte de la solución, eres parte del problema.']);"
Si puedes leer esto, no necesitas lentes.	"Cookie::create(['message' => 'Si puedes leer esto, no necesitas lentes.']);"
Si trabajar es sano, que trabajen los enfermos.	"Cookie::create(['message' => 'Si trabajar es sano, que trabajen los enfermos.']);"
Si tu novia perjudica tu estudio, deja el estudio y perjudica a tu novia.	"Cookie::create(['message' => 'Si tu novia perjudica tu estudio, deja el estudio y perjudica a tu novia.']);"
Si un pajarito te dice algo, debes estar loco pues los pájaros no hablan.	"Cookie::create(['message' => 'Si un pajarito te dice algo, debes estar loco pues los pájaros no hablan.']);"
Si un pájaro te dice que estas loco, debes estarlo pues los pájaros no hablan.	"Cookie::create(['message' => 'Si un pájaro te dice que estas loco, debes estarlo pues los pájaros no hablan.']);"
Si yo fuera tú, dejaría de leer ahora mismo.	"Cookie::create(['message' => 'Si yo fuera tú, dejaría de leer ahora mismo.']);"
Sigue al conejo blanco.	"Cookie::create(['message' => 'Sigue al conejo blanco.']);"
Te dará hambre otra vez en una hora.	"Cookie::create(['message' => 'Te dará hambre otra vez en una hora.']);"
Tener la conciencia limpia es síntoma de mala memoria.	"Cookie::create(['message' => 'Tener la conciencia limpia es síntoma de mala memoria.']);"
Toda cuestión tiene dos puntos de vista: el equivocado y el nuestro.	"Cookie::create(['message' => 'Toda cuestión tiene dos puntos de vista: el equivocado y el nuestro.']);"
Todo lo que sabes es una mentira.	"Cookie::create(['message' => 'Todo lo que sabes es una mentira.']);"
Todo tiempo pasado fue anterior.	"Cookie::create(['message' => 'Todo tiempo pasado fue anterior.']);"
Todo tiempo pasado fue anterior.	"Cookie::create(['message' => 'Todo tiempo pasado fue anterior.']);"
Ultimo momento: gemelo suicida mata hermano por error.	"Cookie::create(['message' => 'Ultimo momento: gemelo suicida mata hermano por error.']);"
Un día leí que las drogas eran malas, desde ese día deje de leer.	"Cookie::create(['message' => 'Un día leí que las drogas eran malas, desde ese día deje de leer.']);"
Una mujer me arrastró a la bebida y nunca tuve la cortesía de darle las gracias.	"Cookie::create(['message' => 'Una mujer me arrastró a la bebida y nunca tuve la cortesía de darle las gracias.']);"
Viejo verde busca jovencita ecologista.	"Cookie::create(['message' => 'Viejo verde busca jovencita ecologista.']);"
Vote por el PAN/PRI/PRD/Partido favorito.	"Cookie::create(['message' => 'Vote por el PAN/PRI/PRD/Partido favorito.']);"
Yo no soy vegetariano porque ame a los animales…..   ¡soy vegetariano porque odio a las plantas!	"Cookie::create(['message' => 'Yo no soy vegetariano porque ame a los animales…..   ¡soy vegetariano porque odio a las plantas!']);"
Yo no sufro de locura, la disfruto a cada minuto.	"Cookie::create(['message' => 'Yo no sufro de locura, la disfruto a cada minuto.']);"
Yo pienso que es mejor no pensar.	"Cookie::create(['message' => 'Yo pienso que es mejor no pensar.']);"
	
